NO ./textures/NO.png
SO ./textures/SO.png
WE ./textures/WE.png
EA ./textures/EA.png

F 220,100,0
C 225,30,0

454441125552222222222222222222222
50000 2b    2                   2
6.00 .11  b 2                   2
1 0  b2   2#2                   2
1     d   2+2                   2
122   7   2+2                   2
21    3   2+2                   2
2     2 N 2+2                   2
2222222   222                   2
2     2   2.2               23  2
2     2   2m2               13  4
222222222d2 2      a  a     22  5
2           2               27  5
2           2      s        22  5
2           8               12K 4
2   3D32222222222 22222233322454
11119X9         3 3
    999          5
