NO ./textures/NO.png
SO ./textures/SO.png
WE ./textures/WE.png
EA ./textures/EA.png

F 220,100,0
C 225,30,0

       
111122222
2   :   2
2   22 22
128232d2:1
2000000002
3000000E06
2000000002
2000000002
2000000002
2000000002
200000000222223335
200000000000000005
200020000000000004
252222255445554554
