NO ./textures/NO.png
SO ./textures/SO.png
WE ./textures/WE.png
EA ./textures/EA.png

F 220,100,0
C 225,30,0

        1111111111111111111111111
        1a000000001100000.00.0001
        1011000a01110K00000000001
        10010a0000000000000000001
111111111011000001110000000000001
100000000011000a01110111110111111
1111011111111101110000001.0+1
1111011111111101110101001a001
1100000011010101110000001#001
100a000000000000110000001#001
1000a000s00000001101010010001
11000001110101011111011110N0111111
11110111 1110101 101111010001
11111111 1111111 111111111111
