NO ./textures/NO.png
SO ./textures/SO.png
WE ./textures/WE.png
EA ./textures/EA.png

F 10,9,18
F 128,0,128
C 128,0,128

        1111111111111111111111111
        1a        11     .  .   1
        1 11   a 111 K          1
        1  1 a                  1
111111111 11     111            1
1         11   a 111 11111 111111
1111 111111111 111      1. +1
1111 111111111 111 1 1  1   1
11      11 1 1 111      1#  1
1  a            11      1#  1
1   a   s       11 1 1  1   1
11     111 1 1 11111 1111 N 111111
1111 111 111 1 1 1 1111 1   1
11111111 1111111 111111111111
