NO ./textures/NO.png
SO ./textures/SO.png
WE ./textures/WE.png
EA ./textures/EA.png

F 220,100,0
C 225,30,0

        1111111111111111111111111
        1000000a001100000+0+00001
        101100000111000B00000B001
        100100a000000000000000001
111111111011000001110000000000001
100000000011000001110111110111111
111101111111110111000000100+1
11110111111111011101010010001
11000000110101011100000010001
10000000000000001100000010001
10000000000000001101010010001
11000001110101011111011110N0111111
11110111 1110101 101111010001
11111111 1111111 111111111111
