NO ./textures/NO.png
SO ./textures/SO.png
WE ./textures/WE.png
EA ./textures/EA.png

F 220,100,0
C 225,30,0

        1111111111111111111111111
        1         11   m .  .   1
        1a11     111 K          1
        1  1             ___ 00 1
111111111 11     111            1
1         11    a111 11111 111111
1111 111111111 111      1. +1
1111 111111111 111 1 1  1  +1
11      11 1 1 111      1# +1
1  a            11      1#  1
1   a   s       11 1 1  1   1
11     111 1 1 11111 1111 N 111111
1111 111 111 1 1 1 1111 1   1
11111111 1111111 111111111111
