NO ./textures/NO.png
SO ./textures/SO.png
WE ./textures/WE.png
EA ./textures/EA.png

F 220,100,0
C 225,30,0

        1111111111111111111111111
        10000000001100000.00.0001
        1011000001110K00000s00001
        10010a0000000000000000001
111111111011000001110000000000001
100000000011000001110111110111111
1111011111111101110000001.0+1
11110111111111011101010010001
1100000011010101110s00001#001
1000000000000000110000001#001
10000000000000001101010010001
1100000111010101111101111000111111
11110111 1110101 101111010001
11111111 1111111 111111111111
