NO ./textures/NO.png
SO ./textures/SO.png
WE ./textures/WE.png
EA ./textures/EA.png

F 220,100,0
C 225,30,0

144444499
1_0+Km0X9
100000199
1N00001
11161d1111
100000s1a1
10000001 1
1        1
1      1 1
1111111111
